#########################################
#     #         #     #     #   #       #
### # ### ### # # ### ### # # # ##### # #
#   #   # #   #   # #   # #   #     # # #
# ##### # # ####### ### # ######### # # #
#   # # # # #   #     #   #       # # # #
### # # ### # # ##### ##### ####### # # #
#   #   #   # #     #     #         # # #
# ### ### ### ##### # # ### ########### #
# #   #   #     #     # #   #         # #
# # ### # # ### # ####### ######### # # #
# #   # # #   # # #     #     #     #   #
# ### ### ##### # # ### ##### # ####### #
#   #     #     # # #       #   #   #   #
# # ####### ####### # ########### # # ###
# #   #             # #         # #   # #
# ### # ############# # ####### # ##### #
# #   # #           # # #   #   #   #   #
### ##### ######### # # # # # ##### # # #
#   #   #   #     # #     # #     # # # #
# ### # ### # ### # ####### ##### # # ###
#   # #     # #     # #   # #   #   #   #
# # # ####### # ##### # ### ### ##### # #
# # #   #   # # #     #       #   #   # #
# # ### ### # ### ##### ##### # # ##### #
# #   #     #     #     #   # # #   #   #
# # # ##### ########### # # # # ### # # #
# # #     #           # # # #   # #   # #
### # ############### ### # ##### ##### #
#   # #             # #   #     #       #
# ##### ########### # # ####### ### #####
# #     #         # #   #     #   # #   #
# # ##### # ### ### ##### # ##### # ### #
# # #O    # #   #   #   # #       #     #
# # ####### ##### # ### # ############# #
# #         #     #     #   #   #     # #
# ######### # ##### ####### # # # # ### #
#     #     # #     #     # # #   #     #
# ##### ##### ####### ### # # ###########
#           #           #   #           #
#########################################